3 4 1005 3974 1822 5842 
2 4 5842 4552 4106 2310 
1 5 2310 4648 121 1902 5949 
1 4 4648 2249 1108 1194 
1 13 1108 5858 1343 4313 5095 343 5860 4703 3698 1826 71 5928 4319 
1 5 343 2741 5791 4922 3278 
3 5 1005 5772 1206 385 541 
2 7 541 4268 1913 1317 5745 938 3278 
2 4 541 255 1290 1194 
1 7 3278 5064 2769 5718 4420 799 5701 
1 5 5701 5684 1886 2699 3295 
1 6 3295 4853 819 5615 2809 5612 
1 5 5612 1040 4808 3747 4241 
1 9 3295 5656 306 3009 5676 2011 2342 1054 4241 
1 6 4241 1860 3256 433 4128 5772 
1 7 1860 3358 5697 4469 4176 5724 4670 
1 6 4670 1481 4300 4371 804 2033 
2 5 2033 2528 2781 197 3918 
1 5 2033 3283 407 2047 4912 
3 8 1005 5043 4385 5329 1496 1390 5845 2781 
1 7 3918 3145 821 2915 144 4338 3228 
2 4 1005 1578 735 4300 
1 4 4319 5955 1603 292 
1 6 4319 3665 2438 5926 4451 140 
1 6 4670 2633 5666 4216 851 5593 
1 14 4912 5692 2907 3849 1656 2516 4372 2729 4061 4976 3707 4601 3120 3193 
1 8 5612 2238 5577 1787 5550 4681 5522 5512 
1 8 5515 1145 3917 1191 4815 2257 5621 3193 
1 10 2257 4185 5606 5047 3407 5584 1034 3333 1865 1810 
1 7 5512 3965 3510 5492 2040 3892 4497 
1 13 5492 3170 280 1514 3060 3061 2988 2402 808 3392 1776 2135 5515 
1 10 5593 4662 480 5209 2992 4365 4757 2051 1396 5515 
2 5 6163 3384 5093 1355 6032 
3 8 6163 4400 3467 5333 1843 1610 3813 1611 
1 5 1611 1591 6104 3037 4438 
1 13 3228 4741 5237 2757 6072 2014 1806 4705 33 2212 3144 2598 6269 
1 8 1806 3749 2177 1789 2518 360 53 1611 
2 4 1611 3807 1944 4756 
1 8 4756 6287 2860 5056 2545 6369 2507 2611 
1 9 6163 4724 6197 3309 3921 597 6300 2568 6337 
1 7 6163 899 1426 4956 6188 6182 684 
1 4 5237 869 789 2867 
1 4 140 2756 2620 5838 
1 8 5838 1283 276 63 5761 2090 5722 3862 
1 5 1838 5694 5355 3948 102 
1 6 3862 5691 1434 1614 2727 5241 
1 3 5241 2737 5590 
1 3 5590 2548 1097 
1 8 1097 5118 663 4793 2982 5592 717 917 
1 8 917 2165 3693 5640 3330 1323 4112 4877 
2 5 1853 3622 291 4340 5785 
1 4 5785 4453 2515 4215 
1 3 3330 2502 4324 
1 6 917 4744 4792 2337 1838 4750 
1 7 4750 1332 5324 3675 1399 5711 3862 
2 5 1853 1114 3618 898 4750 
2 9 1853 619 1295 933 954 2812 2464 4806 5838 
2 6 1853 3288 5833 557 5279 3432 
1 3 813 2083 3432 
1 12 813 5018 257 989 5891 5126 1605 5894 837 5897 1447 2620 
2 7 2971 5084 2557 4546 496 1344 4105 
