3 4 1005 3974 1822 5842 
2 4 5842 4552 4106 2310 
1 5 2310 4648 121 1902 5949 
1 4 4648 2249 1108 1194 
1 13 1108 5858 1343 4313 5095 343 5860 4703 3698 1826 71 5928 4319 
1 5 343 2741 5791 4922 3278 
3 5 1005 5772 1206 385 541 
2 7 541 4268 1913 1317 5745 938 3278 
2 4 541 255 1290 1194 
1 7 3278 5064 2769 5718 4420 799 5701 
1 5 5701 5684 1886 2699 3295 
1 6 3295 4853 819 5615 2809 5612 
1 5 5612 1040 4808 3747 4241 
1 9 3295 5656 306 3009 5676 2011 2342 1054 4241 
1 6 4241 1860 3256 433 4128 5772 
1 7 1860 3358 5697 4469 4176 5724 4670 
1 6 4670 1481 4300 4371 804 2033 
2 5 2033 2528 2781 197 3918 
1 5 2033 3283 407 2047 4912 
3 8 1005 5043 4385 5329 1496 1390 5845 2781 
1 8 3918 3145 821 2915 144 4338 3228 4741 
2 4 1005 1578 735 4300 
2 6 1344 2283 4546 2557 5084 2971 
1 4 4319 5955 1603 292 
1 6 4319 3665 2438 5926 4451 140 
1 6 4670 2633 5666 4216 851 5593 
1 14 4912 5692 2907 3849 1656 2516 4372 2729 4061 4976 3707 4601 3120 3193 
1 8 5612 2238 5577 1787 5550 4681 5522 5512 
1 8 5515 1145 3917 1191 4815 2257 5621 3193 
1 10 2257 4185 5606 5047 3407 5584 1034 3333 1865 1810 
1 7 5512 3965 3510 5492 2040 3892 4497 
1 13 5492 3170 280 1514 3060 3061 2988 2402 808 3392 1776 2135 5515 
1 10 5593 4662 480 5209 2992 4365 4757 2051 1396 5515 
